#########
#.......#
#.###A#A#
#..X#...#
#####...#
#..A....#
#.@#....#
#..#.##.#
#.....#.#
#..####.#
#..#.C..#
#########