#######
#.....#
#.###.#
#..X#.#
#####A#
#@...C#
#######