#######
#.....#
#.###.#
#..X#.#
#A###.#
#.....#
#.@#..#
#..#..#
#..#..#
#..#..#
#....C#
#######