#######
#.....#
#.###.#
#..X#.#
#####.#
#....C#
#######