#######
#.....#
#.###.#
#..X#.#
#.###.#
#.....#
#.##..#
#..##.#
##.#..#
#..#.##
#..#.C#
#######